11111111111111111111111111111111
1E0000000C000000000C000000000001
10010100010000111110100010111101
100C0100010000100010100C10100001
10010100010010100010100010100001
1001C10001010010001010C010100001
1001010C01100010C010100010100001
1001010001010010001010001010C001
10010111010010100010111110100001
1P0000000C0000000C0000000000C001
11111111111111111111111111111111