1111111111111111111111111111111111
1E00000000000C0000000000C000000001
1010010100100000101001000000010101
1010010010101010001001000000010101
100000100000C00000100000000C000001
1P00000000000000C00000C00000000001
1111111111111111111111111111111111