1111111111111111
10010000000000C1
1000010001111001
1P0010001E000001
1111111111111111